1111111111111111111111
1111011111011101011111
1C00101111111011111011
1000000P00000000001111
1011101011101C10111011
1111111C111M1010C11011
1000111M11111010111011
1010101011111110101011
1110111010001C10111011
10000000001010000000E1
1111111111111111111111
