111111111111
1P100CMM0001
1010100C0101
101010010101
10C011010101
110100010101
10C10111M101
10M1000001E1
1C1111111111
111111111111
