1111111111111111111111
10100011111C1111111111
1010101111101111111111
1000000P000000000E1111
1C11101011111010111011
11111110111000C0001011
1000111011101010111011
1010101011101110101011
1110111010001010111011
1000C00C10101000000001
1111111111111111111111
