1111111111
1CCCCCC0E1
11M1111011
1111111011
111P000011
1111111111
